00000000000000000022000000
00000000000000000022000000
44444400044444444400444444
44444400044444444400444444
00000000000000000000000000
11111100011000001111111111
11111100011000001111111111
00011100011110111111111100
00011100011110111111111100
00011000000110110044001100
00011000000110110044001100
00011000000111110044001100
00011000000110110044001100
00011100011110111111111100
00002200022200022222222000
00000000000000000000000000
00000000000000000000000000
11111000000111111000011111
11111000011111111110011111
44411000011444444110011444
44411000000444444000011444
44411000000000000000011444
44411000000111111000011444
44411000000122221000011444
44411000000120021000011444
44411000000120021000011444