00000000000000000000000000
00000000000000000000000000
00000000001100110000000000
00000000001100110000000000
00440000441144110000004400
00440000441144110000004400
44114444111111111144441144
44114444111111111144441144
44111111112211221111111144
44111111112211221111111144
44333333111111111133333344
44333333111111111133333344
44333311111111111111333344
44331111111111111111111144
44111111331111113311111144
44111111331111113311111144
44111133333333333333111144
44111133333333333333111144
44443333444444444433334444
44443333444444444433334444
33004444000000000044440033
33004444000000000044440033
00000000001111110000000000
00000000001111110000000000
00000000001100110000000000
00000000001100110000000000