00000022000000000022000000
00000022000000000022000000
44444400444444444400444444
44444400444444444400444444
00000000000000000000000000
11111111111000001111111111
11111111111000001111111111
00011111111110111111111100
00011111111110111111111100
00011004400110110044001100
00011004400110110044001100
00011004400111110044001100
00011004400110110044001100
00011111111110111111111100
00002222222200022222222000
00000000000000000000000000
00000000000000000000000000
11111000000111111000011111
11111000011111111110011111
44411000011444444110011444
44411000000444444000011444
44411000000000000000011444
44411000000111111000011444
44411000000111111000011444
44411000000110011000011444
44411000000110011000011444