00444400000000000000444400
00444400000000000000444400
44443300000111100000334444
44443300011111111100334444
44000001111111111111000044
44000011111111111111110044
20000111111111111110011002
00001111100000111100000100
00011100000000011100000000
00011003300033001100000000
00111003300033001111000000
33011000000000001111000333
33011100011100011110000333
00001110011100111110000000
00000111111111111111100000
00001111111111111111111000
00011111111111111111111100
00000000011111111100000000
00000000000111100000000000
00000000000000000000000000
00000000000000000000000000
00000000000000000000000000
22000000001111110000000022
00000000001111110000000000
00000000001100110000000000
00000000001100110000000000