00000000000000000000000000
00000000000000000000000000
00000000000000000000000033
00000000000000000000000033
20000222222222222220002233
00000004444444444000000033
20000222222222222220002233
00000000000000000000000033
00000000000000000000000033
00000000000000000000000033
00000000000000000000000033
00000000000000000000000033
00000000000000000000000033
00000000000000000000000033
20000222222222222220002233
00000004444444444000000033
20000222222222222220002233
00000000000000000000000033
00000000000000000000000033
02112000000000000002112033
02112000000000000002112033
22112200000000000022112233
21111200001111110021111233
21111200001111110021111233
22222200001100110022222200
00000000001100110000000000