00000000000000000000000000
00000000000000000000000000
44444000111111111100044444
44440011111111111111004444
44400111111111111111100044
40000111111111111111100004
00001111222211222211110000
00001111222211222211110000
00001111222211222211110000
00001111111111111111110000
00001111111111111111110000
00001111111111111111110000
00000011111111111111000000
00000011111111111111000000
00000011111111111111000000
44444011111111111111004444
44444001010101010101004444
33333001010101010101033333
33333010101010101010033333
44444001010101010101044444
44444000000000000000044444
00200000000000000000000200
00000000001111110000000000
11111000001111110000011111
20202000001100110000020202
20202000001100110000020202