00000022000000000022000000
00000022000000000022000000
00440000000444400000004400
00440000000444400000004400
20000000000000000000000002
11110000000000000000001111
01111111100000000011111110
00011111111110111111111100
00011111111110111111111100
00011004400110110044001100
00011004400110110044001100
00011004400112110044001100
00011004400110110044001100
00011111111110111111111100
00011111111220221111111100
00000000111000001110000000
00000000000000000000000000
11111000000000000000011111
11111001111111111110011111
00011000004400440000011000
00011000004400440000011000
00011000000000000000011000
44411000001111110000011444
44411000001111110000011444
00011000001100110000011000
00011000001100110000011000