00000000000000000000000000
00000000000000000000000000
00000000033333333000000000
00000000033333333000000000
00000000033333333000000000
33003300533333333500330033
33003300555333355500330033
00330000555333355500003300
00330000555333355500003300
00000000335555553300000000
00000000235555553200000000
00000000233111133200000000
00332222233100133222223300
00330000233111133200003300
00330000233333333200003300
00000000333333333300000000
00000000333111133300000000
33330000333111133300003333
33330002333311333320003333
33330002333311333320003333
33330004444000044440003333
00000004444000044440000000
00000204441111114440200000
00000004441111114440000000
00000004441133114440000000
00000004441133114440000000