00000000000000000000000000
00000000000000000000000000
00000000000000000000000000
44444444444444444444444444
44444444444444444444444444
00000222224444442222200000
00000222224444442222200000
00000000114444441100000000
00000000114444441100000000
44333311114444441111333344
44333311444444444411333344
44113322444422444422331144
44113322444422444422331144
44113311114444441111331144
44113311114444441111331144
44111111331111113311111144
44111133333111133333111144
44443333444444444433334444
44443333444444444433334444
33004444000000000044440033
33004444000000000044440033
00000000000000000000000000
00000000001111110000000000
00000000001111110000000000
00000000001100110000000000
00000000001100110000000000
