00000024200000000242000000
00000022200000000222000000
22220000000222200000002222
44420000000233200000002444
33420000000233200000002433
33420000000233200000002433
33420000000233200000002433
33420000000233200000002433
33420000000233200000002433
33420000000233200000002433
33420000000233200000002433
33420000000233200000002433
33420000000233200000002433
33420000000233200000002433
33420000000233200000002433
33420000000233200000002433
33420000000233200000002433
33420000000233200000002433
44420000000233200000002444
22220000000222200000002222
00000000000000000000000000
00000000000000000000000000
44444000001111110000044444
44444000001111110000044444
44444000001133110000044444
44444000001133110000044444